{
{0,0,4,1,0,3,0,0,7},
{3,0,0,0,0,2,9,0,0},
{0,5,0,6,0,0,0,0,0},
{6,3,0,0,2,5,0,0,9},
{1,0,2,7,4,9,5,0,6},
{5,0,0,3,1,0,0,7,2},
{0,0,0,0,0,1,0,5,0},
{0,0,6,5,0,0,0,0,1},
{2,0,0,9,0,7,3,0,0}
}